3 3 3 3 7 3 3 3 3 3 3 3 3 3 3 3 3 3 3 3 3 3 3 3 3 3 3 3 3 3 3 3 3 3 3 3 3 3 3 3 3 3 3 3 3 3 3 3 3 3 
2 2 2 2 7 2 2 2 2 2 2 2 2 2 2 2 2 2 2 2 2 2 2 2 2 2 2 2 2 2 2 2 2 2 2 2 2 2 2 2 2 2 2 2 2 2 2 2 2 2 
1 1 1 1 7 1 1 1 1 1 1 1 1 1 1 1 1 1 1 1 1 1 1 1 1 1 1 1 1 1 1 1 1 1 1 1 1 1 1 1 1 1 1 1 1 1 1 1 1 1 
1 1 1 1 7 1 1 1 1 1 1 1 1 1 1 1 1 1 1 1 1 1 1 1 1 1 1 1 1 1 1 1 1 1 1 1 1 1 1 1 1 1 1 1 1 1 1 1 1 1 
1 4 4 4 4 4 4 4 4 4 1 1 1 1 1 1 1 1 4 4 4 4 4 4 4 4 4 4 4 4 4 4 4 4 4 4 4 4 4 4 4 4 4 4 4 4 4 4 4 4 
1 4 4 4 4 4 4 4 4 4 1 1 1 1 1 1 1 1 4 4 4 4 4 4 4 4 4 4 4 4 4 4 4 4 4 4 4 4 4 4 4 4 4 4 4 4 4 4 4 4 
1 0 0 0 0 0 0 0 0 5 1 1 1 1 1 1 1 1 5 5 0 0 0 0 0 0 0 0 0 0 0 0 0 0 0 0 0 3 0 0 0 0 0 0 0 0 0 0 0 3 
3 0 0 0 0 0 0 0 0 5 1 1 1 1 1 1 1 1 5 5 0 0 0 0 0 0 0 0 0 0 0 0 0 0 0 0 0 2 0 0 0 0 3 0 0 0 0 0 0 2 
2 0 0 0 0 0 0 0 5 5 1 1 1 1 1 1 1 1 5 5 5 0 0 0 0 0 0 0 0 0 0 0 0 0 0 0 0 0 0 0 0 0 2 0 0 0 0 0 0 3 
3 3 0 0 0 0 0 0 5 5 1 1 1 1 1 1 1 1 5 5 5 0 0 3 0 0 0 0 0 3 0 0 0 0 0 0 0 0 0 0 0 0 0 0 0 0 0 0 0 2 
2 2 0 0 0 0 0 0 5 5 1 1 1 1 1 1 1 1 5 5 5 0 0 2 0 0 0 0 0 2 0 0 0 0 0 6 6 6 6 6 6 6 6 6 0 0 0 0 0 3 
3 0 0 0 0 0 0 0 5 5 1 1 1 1 1 1 1 1 5 5 5 0 0 0 0 0 0 0 0 0 0 0 0 3 0 6 8 8 8 8 8 9 8 6 0 0 0 0 0 2 
2 0 0 0 0 0 0 0 0 5 1 1 1 1 1 1 1 1 5 5 5 0 0 0 0 5 5 5 0 0 0 0 0 2 0 6 8 8 8 8 8 8 8 6 0 0 0 0 0 3 
3 0 0 0 0 0 0 0 0 5 1 1 1 1 1 1 1 1 5 5 5 5 5 5 5 5 5 5 5 0 0 0 0 0 0 6 8 8 8 8 8 8 8 6 0 0 0 0 0 2 
2 3 0 0 0 0 0 0 0 5 1 1 1 1 1 1 1 1 5 5 5 5 5 5 5 5 5 5 5 0 0 0 0 0 0 6 8 8 8 8 8 8 8 6 0 0 0 0 0 3 
3 2 0 0 0 0 0 3 0 5 1 1 1 1 1 1 1 1 1 1 1 1 1 1 1 1 5 5 5 0 0 0 0 0 0 6 6 6 6 8 6 6 6 6 0 0 0 0 0 2 
2 0 0 0 0 0 0 2 0 5 1 1 1 1 1 1 1 1 1 1 1 1 1 1 1 1 5 5 5 0 3 0 0 0 0 0 0 0 0 0 0 0 0 0 0 0 0 0 0 3 
3 0 0 0 0 0 0 0 0 5 1 1 1 1 1 1 1 1 1 1 1 1 1 1 1 1 5 5 5 5 2 0 0 0 0 0 0 0 0 0 0 0 0 0 0 0 0 0 0 2 
2 0 0 0 0 0 0 0 0 5 1 1 1 1 1 1 1 1 1 1 1 1 1 1 1 1 5 5 5 5 0 0 0 0 0 0 0 0 0 0 0 0 0 0 0 0 0 0 0 3 
3 0 0 0 0 0 0 0 0 5 5 5 5 5 5 5 5 5 5 5 1 1 1 1 1 1 5 5 5 5 0 0 0 3 0 0 0 0 0 0 0 3 0 0 0 0 0 0 0 2 
2 0 0 0 0 0 0 0 0 0 0 0 5 5 5 5 5 5 5 5 1 1 1 1 1 1 5 5 5 5 0 0 0 2 0 0 0 0 0 0 0 2 0 0 0 5 5 5 5 5 
3 0 0 0 0 0 0 0 0 0 0 0 0 3 0 0 0 0 5 5 1 1 1 1 1 1 5 5 5 5 0 0 0 0 0 0 0 0 0 0 0 0 0 0 5 5 1 1 1 1 
2 0 3 0 0 0 0 0 0 0 0 0 0 2 0 0 0 0 7 7 7 7 7 7 7 7 7 7 5 5 0 0 0 0 0 0 0 0 0 0 0 5 5 5 5 1 1 1 1 1 
3 0 2 0 0 0 0 0 0 0 0 0 0 0 0 0 0 0 7 7 7 7 7 7 7 7 7 7 5 0 0 0 0 0 0 0 0 0 0 0 0 5 1 1 1 1 1 1 1 1 
2 0 0 0 0 0 0 0 0 0 0 0 0 0 0 0 0 0 7 7 7 7 7 7 7 7 7 7 5 0 0 0 0 0 0 0 0 0 0 0 5 5 1 1 1 1 1 1 1 1 
3 0 0 0 0 0 0 0 0 0 0 0 0 0 0 0 0 0 7 7 7 7 7 7 7 7 7 7 5 0 0 0 0 0 0 0 0 0 0 5 5 1 1 1 1 1 1 1 1 1 
2 0 0 0 0 0 0 0 0 0 0 0 0 0 0 0 0 0 0 5 1 1 1 1 1 1 5 5 5 0 0 0 0 0 0 0 0 0 0 5 1 1 1 1 1 1 1 1 1 1 
3 0 0 0 3 0 0 0 0 0 0 0 3 0 0 0 0 0 0 5 1 1 1 1 1 1 5 5 5 0 0 0 0 0 0 0 0 0 0 5 1 1 1 1 1 1 1 1 1 1 
2 0 0 0 2 0 0 0 0 0 0 0 2 0 0 0 0 0 5 5 1 1 1 1 1 1 5 5 0 0 0 0 0 0 0 0 0 0 0 5 1 1 1 1 1 1 1 1 1 1 
3 0 0 0 0 0 0 0 0 0 0 0 0 0 0 0 0 0 5 5 1 1 1 1 1 1 5 5 0 0 3 0 0 0 0 0 0 0 0 5 1 1 1 1 1 1 1 1 1 1 
2 0 0 0 0 0 0 0 0 0 0 0 0 0 0 0 0 0 5 5 1 1 1 1 1 1 5 5 0 0 2 0 0 0 0 0 0 0 0 5 5 1 1 1 1 1 1 1 1 1 
3 0 0 0 3 0 0 0 0 0 0 0 0 0 0 3 0 0 0 5 1 1 1 1 1 1 5 5 0 0 0 0 0 0 0 0 0 0 0 0 5 1 1 1 1 1 1 1 1 1 
2 0 0 0 2 0 0 0 0 0 0 0 0 0 0 2 0 0 0 5 1 1 1 1 1 1 5 5 5 0 0 0 0 0 0 0 0 0 0 0 0 5 5 1 1 1 1 1 1 1 
3 0 0 0 0 0 0 0 0 0 0 0 0 0 0 0 0 0 0 5 1 1 1 1 1 1 5 5 5 0 0 0 0 0 0 0 0 0 0 0 0 0 0 5 5 5 5 1 1 1 
2 0 0 0 0 0 0 0 0 0 0 0 0 0 0 0 0 0 0 5 1 1 1 1 1 1 5 5 5 0 0 0 0 0 0 0 0 0 0 0 0 0 0 0 3 0 5 5 5 5 
3 0 3 0 0 0 0 0 0 0 0 0 0 0 0 0 0 0 0 5 1 1 1 1 1 1 5 5 5 0 0 0 0 0 0 0 0 0 0 0 0 0 0 0 2 0 0 0 0 3 
2 0 2 0 0 0 0 0 0 0 0 0 0 0 0 0 0 0 0 5 1 1 1 1 1 1 5 5 5 0 0 0 0 0 0 0 0 0 0 0 0 0 0 0 0 0 0 0 0 2 
3 0 0 0 0 0 0 0 0 0 0 0 0 0 0 0 0 0 0 5 1 1 1 1 1 1 5 5 5 0 0 0 0 0 0 0 0 0 0 0 0 0 0 0 0 0 0 0 0 3 
2 0 0 0 0 0 0 0 0 0 0 0 0 0 0 0 0 0 0 5 1 1 1 1 1 1 5 5 5 0 0 0 0 0 0 0 3 0 0 0 0 0 0 0 0 0 0 0 0 2 
3 0 0 0 0 0 0 0 0 0 0 0 0 0 0 0 0 0 0 5 1 1 1 1 1 1 5 5 5 0 0 0 0 0 0 0 2 0 4 4 4 4 4 4 4 4 4 4 4 4 
2 0 0 0 0 0 0 0 0 0 0 0 0 4 4 4 4 4 4 4 1 1 1 1 1 1 4 4 4 4 4 4 4 4 4 4 4 4 4 4 4 4 4 4 4 4 4 4 4 4 
0 0 0 0 0 4 4 4 4 4 4 4 4 4 4 4 4 4 4 4 1 1 1 1 1 1 4 4 4 4 4 4 4 4 4 4 4 4 4 4 4 4 4 4 4 4 4 4 4 4 
4 4 4 4 4 4 4 4 4 4 4 4 4 4 4 4 4 4 4 4 1 1 1 1 1 1 4 4 4 4 4 4 4 4 4 4 4 4 4 4 4 4 4 4 4 4 4 4 4 4 
4 4 4 4 4 4 4 4 4 4 4 4 4 4 4 4 4 4 4 4 1 1 1 1 1 1 4 4 4 4 4 4 4 4 1 1 1 1 1 1 1 1 1 1 1 1 1 1 1 1 
4 4 4 4 4 4 4 4 4 4 1 1 1 1 1 1 1 1 1 1 1 1 1 1 1 1 1 1 1 1 1 1 1 1 1 1 1 1 1 1 1 1 1 1 1 1 1 1 1 1 
1 1 1 1 1 1 1 1 1 1 1 1 1 1 1 1 1 1 1 1 1 1 1 1 1 1 1 1 1 1 1 1 1 1 1 1 1 1 1 1 1 1 1 1 1 1 1 1 1 1 
1 1 1 1 1 1 1 1 1 1 1 1 1 1 1 1 1 1 1 1 1 1 1 1 1 1 1 1 1 1 1 1 1 1 1 1 1 1 1 1 1 1 1 1 1 1 1 1 1 1 
1 1 1 1 1 1 1 1 1 1 1 1 1 1 1 1 1 1 1 1 1 1 1 1 1 1 1 1 1 1 1 1 1 1 1 1 1 1 1 1 1 1 1 1 1 1 1 1 1 1 
1 1 1 1 1 1 1 1 1 1 1 1 1 1 1 1 1 1 1 1 1 1 1 1 1 1 1 1 1 1 1 1 1 1 1 1 1 1 1 1 1 1 1 1 1 1 1 1 1 1 
1 1 1 1 1 1 1 1 1 1 1 1 1 1 1 1 1 1 1 1 1 1 1 1 1 1 1 1 1 1 1 1 1 1 1 1 1 1 1 1 1 1 1 1 1 1 1 1 1 1 

